11111111111111111111111111111111111111111
10000010000000100000001000100010000000001
10101011101110101110101010101110111011101
10101000001010000010101010000010100000101
10101110101010111011101010101110101110111
10101000101000100010000010100010100010001
10101110101110111111101011101011101110111
10101000101000100000001000101010001000121
10111110111011111010111010111110111010101
10000010100000100010001010000000100010001
11111111111111111111111111111111111111111